333WWWWWWWWWWWWWWWWWWWWWWWWWW
333W000000000000W66666W66666W
333W000000000000066666W66666W
333W00000WWWW0WWW66666W66666W
333W00000W555555W66666W66666W
333W00000W555555W66666W66666W
333W00000W555555066666666666W
333W00000W555555W66666666666W
WWWW00000WWWWWWWWWWWWWWWWWWWW
W000000000000000000000000000W
W000000WWWWWWWWWWWWWWWW00000W
W000000000000000000000000000W
WWW0WWWWWWWWWWWWWWWWWWWWW0WWW
W444444W44444444444444W44444W
W444444W4444444W444444444444W
W444444W4444444W444444W44444W
W444444W4444444W444444W44444W
W44444444444444W444444W44444W
W444444W44444444444444W44444W
WWWWWWWWWWWWWWWWWWWWWWWWWWWWW