WWWWWWWWW111111111WWWWWWWWWWWW
W0000000WWWWWWWWWWW0000000000W
W0000000W222222222W0000000000W
W0000000W222222222W0000000000W
W00000000222222222W0000000000W
W0000000W222222222W0000000000W
W0000000WW0WWWWW0WWWWWWWWWW0WW
W0000000W00000W0000W000000000W
W0000000W00000W0000W000000000W
W0000000W0000000000W00WWWW000W
W0000000W00000W00000000000000W
W0000000W00000W00000000000000W
W0000000W00000W00000WWW0WWWWWW
W0000000W000000000000W1111111W
W0000000000000W000000W1111111W
W0000000W00000W000000W11M1111W
WWWWWWWWWWWWWWWWWWWWWW1111111W
111111111111111111111W1111111W
111111111111111111111W1111111W
111111111111111111111WWWWWWWWW
